XXXXXXXXX
O XSXOX S
X   P 1 X
X2  P   X
XXXDXDXXX
